11 11 12 8 9 9 5 3 5 3 5 3 5 5 5 5 5 5 3 5 5 3 5 5 5 3 5 5 6 6 6 6 6 5 5 5 5 5 5 5 5 5 5 3 5 5 5 5 5 5 
11 11 11 11 8 9 9 5 5 3 5 5 5 5 5 5 5 5 5 5 5 5 5 5 5 5 5 5 6 6 6 6 6 5 5 5 5 5 5 5 5 5 5 5 5 5 5 5 3 5 
11 11 11 11 8 8 9 9 5 5 5 5 5 3 3 5 5 3 3 5 5 5 5 5 3 5 5 5 1 6 6 6 1 5 5 5 5 5 5 5 3 5 5 5 5 5 5 5 5 5 
12 11 11 11 8 8 8 8 5 5 5 3 5 5 5 3 5 5 3 5 5 3 5 5 5 3 5 1 1 6 6 6 1 5 5 5 3 5 5 3 5 5 5 5 5 5 5 5 5 5 
12 12 12 11 12 12 8 8 8 8 5 5 5 5 5 5 5 5 3 5 5 5 5 5 5 5 5 1 6 6 6 6 1 5 5 5 5 5 5 5 5 5 5 5 5 3 5 5 5 5 
12 12 12 11 12 12 12 12 8 8 8 5 5 5 5 5 5 5 3 3 5 5 5 5 5 5 5 0 6 6 6 1 1 5 5 5 5 5 5 5 5 5 4 4 5 5 5 5 3 5 
8 8 12 11 11 11 12 12 12 8 8 8 5 5 5 3 5 5 5 5 5 5 5 5 3 5 5 0 6 6 6 1 5 5 5 5 5 5 5 3 5 5 3 4 5 5 5 3 5 5 
9 9 12 12 12 11 11 12 12 12 8 8 8 5 5 5 5 5 5 5 5 3 3 5 5 5 0 1 6 6 1 1 5 5 5 3 5 5 5 5 5 5 3 4 5 5 5 5 5 5 
9 9 8 12 12 12 11 12 12 12 8 8 8 8 5 5 5 5 5 3 5 5 5 5 5 5 1 6 6 6 1 5 5 5 5 3 5 5 5 5 5 3 3 5 5 5 5 5 5 5 
9 9 9 8 12 12 11 11 11 12 12 12 8 8 8 5 5 5 5 5 5 3 5 5 5 1 1 6 6 6 1 5 3 5 5 5 5 5 5 5 5 5 5 5 5 5 5 5 5 5 
5 9 9 9 12 11 11 11 11 11 12 11 11 11 8 8 5 5 3 5 5 5 3 5 1 1 6 6 6 1 1 5 5 5 5 5 5 5 5 5 5 5 5 5 5 5 5 5 5 5 
5 5 9 9 12 11 11 11 12 11 12 11 11 11 8 8 8 8 5 5 5 5 5 1 1 6 6 6 6 1 5 5 5 5 5 5 5 5 5 5 1 1 1 1 1 1 1 1 1 5 
5 5 9 9 8 11 11 11 12 11 11 11 11 11 10 12 12 8 8 5 5 5 1 1 6 6 6 6 1 1 5 5 5 5 3 5 5 5 5 5 1 6 6 6 6 6 6 6 1 5 
5 4 5 9 9 12 12 12 10 10 12 11 12 12 10 11 11 11 8 8 5 1 1 6 6 6 6 1 1 5 5 5 5 5 5 5 5 5 5 5 1 6 6 6 6 6 6 6 1 5 
4 5 5 5 8 8 12 12 12 10 10 11 11 12 10 11 11 11 8 8 1 1 6 6 6 6 6 1 5 5 5 5 5 5 5 3 5 5 5 5 1 6 6 6 6 6 6 6 1 5 
5 5 4 5 5 8 8 12 12 12 10 10 11 12 10 11 11 11 12 1 1 6 6 6 6 6 1 1 5 5 5 5 5 5 5 5 5 5 5 5 1 6 6 6 6 6 6 6 1 5 
5 4 5 5 5 8 8 8 12 12 12 10 11 12 10 10 12 12 12 1 6 6 6 6 6 1 1 5 5 5 5 5 5 5 5 5 5 5 5 5 1 6 6 6 6 6 6 6 1 5 
4 5 5 5 5 5 8 8 8 12 12 10 10 12 12 12 12 12 1 1 6 6 6 6 1 1 5 5 5 5 5 5 5 3 5 5 5 5 5 5 1 6 6 6 6 6 6 6 1 5 
5 5 4 5 5 5 5 8 8 8 12 12 11 11 11 11 12 1 1 6 6 6 6 1 1 5 5 5 5 5 5 5 5 5 4 5 5 5 5 5 1 1 1 5 5 5 1 1 1 5 
5 5 5 5 5 5 5 5 8 8 8 12 11 11 11 11 12 1 6 6 6 6 1 1 9 8 5 5 5 5 5 5 5 3 5 5 5 5 5 5 5 5 5 5 5 5 5 5 5 5 
5 5 5 5 4 5 5 5 4 8 8 12 11 11 11 11 1 1 6 6 6 1 1 8 9 9 9 8 5 5 5 3 5 4 5 5 3 5 5 5 5 5 3 5 5 5 5 5 5 5 
5 5 5 5 5 5 5 5 5 8 8 12 11 11 11 12 1 6 6 6 6 1 12 12 12 12 9 9 8 5 5 5 5 5 5 5 5 5 5 3 5 5 5 5 5 5 5 5 5 5 
5 4 5 5 5 5 5 5 5 8 8 12 12 12 12 1 1 6 6 6 1 1 12 11 11 11 11 9 9 5 5 5 5 3 5 5 5 5 5 5 5 5 5 5 5 5 5 4 5 5 
5 5 5 5 5 5 5 5 5 5 8 8 12 12 12 1 6 6 6 6 1 12 12 11 11 11 11 12 9 9 5 5 5 5 5 5 5 5 3 5 5 5 5 3 5 5 5 5 5 5 
5 5 5 5 4 5 5 5 5 5 9 9 8 12 1 6 6 6 6 1 1 12 10 11 11 11 11 12 8 9 8 5 5 5 5 5 5 3 5 5 5 5 5 5 5 5 5 5 4 5 
5 5 5 5 5 5 5 5 5 5 5 9 8 1 1 6 6 6 6 1 12 12 10 12 11 11 11 12 8 9 9 5 5 3 5 5 5 5 5 5 5 5 5 5 5 5 5 5 5 4 
5 5 5 5 5 5 4 5 5 5 5 9 1 1 6 6 6 6 1 1 12 10 10 12 11 11 11 12 12 8 9 9 5 5 5 5 5 8 8 9 9 9 9 8 5 5 5 5 5 5 
5 5 5 5 5 5 5 5 5 4 5 1 1 6 6 6 6 1 1 12 12 10 11 11 11 12 10 10 12 8 9 9 9 9 9 8 9 9 8 8 8 8 8 8 8 9 9 5 5 5 
4 5 5 5 5 5 5 5 5 5 1 1 6 6 6 6 6 1 12 12 12 10 12 12 11 11 11 11 10 10 9 9 9 8 8 8 9 9 12 12 12 12 12 12 8 8 9 9 9 8 
5 5 5 5 5 5 5 5 5 5 1 6 6 6 6 6 1 1 12 12 12 10 12 12 11 11 11 11 11 10 12 12 12 12 12 12 12 12 12 12 12 12 12 12 12 12 12 8 8 8 
5 5 5 4 5 5 5 5 5 5 1 6 6 6 6 1 1 9 12 10 11 11 11 12 11 11 11 11 11 12 12 12 12 12 12 10 10 10 10 10 12 12 12 12 12 11 11 11 12 12 
5 5 5 5 5 5 5 5 5 5 1 6 6 6 6 1 8 9 12 12 11 11 11 12 10 11 11 11 11 12 12 12 12 11 11 11 11 11 11 10 10 12 12 12 12 11 11 11 12 12 
5 5 5 5 5 5 5 5 5 1 1 6 6 6 1 1 5 9 9 12 11 11 11 11 11 11 11 11 11 11 11 11 11 11 11 11 11 11 11 12 10 10 10 10 11 11 11 11 12 12 
5 5 5 5 5 5 5 5 5 1 6 6 6 6 1 5 5 8 9 12 11 11 11 11 11 11 11 11 11 11 11 11 11 11 11 11 11 11 11 11 11 11 11 11 11 11 11 11 12 12 
5 5 5 5 5 5 4 5 5 1 6 6 6 1 1 5 5 5 9 9 11 11 11 11 11 11 11 11 11 11 11 11 11 11 11 11 11 11 11 11 11 11 11 11 11 11 11 11 12 12 
5 5 5 5 5 5 5 5 5 1 6 6 6 1 5 5 5 5 8 9 9 12 12 12 12 12 12 11 11 11 11 11 11 11 11 12 11 11 11 11 11 11 11 11 11 11 11 11 11 11 
5 5 5 5 5 5 5 5 5 1 6 6 6 1 5 5 5 5 5 5 9 9 9 9 9 12 12 11 11 11 11 11 11 11 11 12 12 12 12 12 11 11 11 11 11 11 11 11 12 12 
5 5 5 5 5 5 4 5 5 1 6 6 6 1 5 5 5 5 5 5 5 8 8 9 9 8 8 8 11 11 11 11 11 11 11 10 10 10 11 11 11 11 11 11 11 11 11 11 12 12 
5 5 5 5 5 5 5 5 5 1 6 6 6 1 5 5 5 4 5 5 5 5 5 5 5 7 7 7 7 11 11 11 11 11 11 12 12 12 11 11 11 11 11 11 11 11 11 11 12 12 
5 5 5 5 4 5 5 5 5 1 6 6 6 1 5 5 5 5 5 5 5 5 5 5 5 5 5 5 7 11 11 11 11 11 11 12 12 12 11 11 11 11 11 11 11 11 12 12 12 12 
5 5 5 4 4 5 5 5 5 1 6 6 6 1 5 5 5 5 5 5 5 4 5 5 5 5 5 5 5 7 7 7 8 12 12 12 12 12 12 12 12 12 12 12 12 12 12 12 12 12 
5 5 5 4 5 5 5 5 5 1 6 6 6 1 5 5 5 5 5 5 5 5 5 5 5 3 5 5 5 5 5 7 7 7 7 12 9 9 7 7 7 9 9 9 7 12 12 7 7 7 
5 5 5 5 4 5 5 4 5 1 6 6 6 1 5 5 5 4 4 5 5 5 5 5 5 5 5 5 5 5 5 5 5 5 7 7 7 9 9 9 9 9 7 9 9 9 9 9 7 7 
5 4 5 5 5 5 5 4 5 1 6 6 6 1 5 5 5 5 5 5 5 5 5 5 5 4 5 5 5 5 5 5 5 5 5 5 5 5 5 7 7 9 5 5 5 7 7 9 7 7 
5 5 5 5 5 5 5 4 5 1 6 6 6 1 5 5 5 5 5 5 5 5 5 5 5 5 5 5 5 5 5 5 5 5 5 5 5 5 5 5 5 5 5 5 5 5 5 5 5 5 
5 4 4 5 5 5 5 3 5 1 6 6 6 1 5 5 5 5 5 5 5 4 4 5 5 5 5 5 4 5 5 4 5 5 4 5 5 5 5 5 5 5 4 5 5 5 4 5 4 5 
5 5 5 5 5 5 5 5 5 1 6 6 6 1 5 5 4 5 5 5 5 5 5 5 5 5 5 5 4 4 4 5 5 5 5 5 5 5 5 5 4 5 5 5 5 5 5 5 5 5 
5 5 5 5 5 5 5 5 5 6 6 6 6 6 5 5 4 5 5 5 5 5 5 5 5 5 5 5 5 4 5 5 5 5 5 5 4 5 5 5 5 5 5 4 4 5 5 5 4 5 
5 5 5 5 5 5 5 5 5 6 6 6 6 6 5 5 5 5 5 5 5 5 5 5 5 5 5 5 5 5 5 5 5 5 5 5 5 5 5 5 5 5 5 5 5 5 5 5 5 5 
5 5 5 5 5 5 5 5 5 6 6 6 5 5 5 5 0 0 0 0 0 0 0 0 0 0 0 0 0 0 0 0 0 0 0 0 0 0 0 0 0 0 0 0 0 0 0 0 0 0